NO textures/greystone.png
SO textures/mossy.png
WE textures/purplestone.png
EA textures/wood.png

F 69,222,199
C 235,198,52

   111111111111111111111111111111111111111111111111111111111111111111111111
111100000000000000000000001000000000000000000001110000000000000000000000001
100100000000000000000001111000000000000000000000010000000000000000000000001
100100000000000000000000001000000000000000000000000000000000000000000000001
100000000000000000000001111000000000000000000000000000000000000000000000001
111100000000000000000000000000000000000000000000000000000000000000000000001
100000000000000000000001000000000000000000001110000000000000000000000001111
10000000000000000000111100000000000000000000111000000000000000000000000111
10000000000000000000000100000000000000000000000000000000000000000000000111
10000000000000000000000100000000000000000000000000000000000000000000000111
10000000000000000000000000000000000000000000000000000000000000000000000001
111100000000000001000011111111111111111111111111111111111111111111111111001
100000111110000101010001100000111110000101010001100000111110000101010001101
100000100010000000000000000000000000000000000001100000111110000101010000001
100000100010N00100010001100000100010000100010000000000100010000100000001001
10000010001000000000000110000011110000101010000110000000000000000000000111
10000011100000101010000110000011110000101010000110000011110000111110000111
11111111111111111111111111111111111111111111111111111111111111111111111111
