NO textures/greystone.png
SO textures/mossy.png
WE textures/purplestone.png
EA textures/wood.png

F 69,222,199
C 235,198,52

   111111111111111111111111111111111111111111111111111111111111111111111111
   100000000000000000000001000000000000000000001110000000000000000000000001
   100000000000000000001111000000000000000000000010000000000000000000000001
   100000000000000000000001000000000000000000000000000000000000000000000001
   100000000000000000000001000000000000000000000000000000000000000000000001
   100000000000000000000000000000000000000000000000000000000000000000000001
111100000000000001000011111111111111111111111111111111111111111111111111111
100000111110000101010001                                                   
100000100010000000000001                                                        
100000100010N00100010001                                                       
100000100010000000000001                                                      
100000111100001010100001                                                       
111111111111111111111111                                                    
