NO textures/north.xpm42
SO textures/south.xpm42
WE textures/west.xpm42
EA textures/east.xpm42
F 220,100,0
C 225,30,0

111111
100101
100001
10W001
100001
111111