NO textures/north.xpm42
SO textures/south.xpm42
WE textures/west.xpm42
EA textures/east.xpm42
F 220,100,0
C 255,231,176

1111111
1001001
1001001
100N001
1000001
1111111