NO textures/purpleish.png
SO textures/yellowish.png
WE textures/turquoise.png
EA textures/greenish.png

F 220,100,0
C 255,231,176

1111111
1001001
1001001
100N001
1030201
1111011
