NO textures/purpleish.png
SO textures/yellowish.png
WE textures/turquoise.png
EA textures/greenish.png

F 220,100,0
C 255,231,176

1111111
1002001
1001121
1001001
10000N1
1111111
