NO textures/purpleish.png
SO textures/yellowish.png
WE textures/turquoise.png
EA textures/greenish.png

F 220,100,0
C 255,231,176

1111111
1002001
1E01001
1000001
1000001
1111111
