NO textures/greystone.png
SO textures/mossy.png
WE textures/purplestone.png
EA textures/wood.png
F 220,0,0
C 225,30,0
1111111
100101  
101001111
1100S1  
11111111 