NO textures/north.xpm42
SO textures/south.xpm42
WE textures/west.xpm42
EA textures/east.xpm42
F 220,100,0
C 225,30,0
111111
100101
101001
1100N1
111111


111111
110101
1010011
1100N11
1111111