NO textures/north.xpm42
SO textures/south.xpm42
WE textures/west.xpm42
EA textures/east.xpm42
F 220,0,0
C 225,30,0
111111
100101
101001
1100E1
111111