NO textures/redbrick.png
SO textures/redbrick.png
WE textures/eagle_portrait.png
EA textures/eagle_landscape.png

C 99,0,107
F 80,80,80

1 1 11111111111111111111111
110 00110000100000000000001
1 0 00110000000000111111001
1 0 0011000000N000110001001
1 0 00000000100000000001001
1 1 11111111111111111111111