NO textures/redbrick.png
SO textures/redbrick.png
WE textures/eagle_portrait.png
EA textures/eagle_landscape.png

C 220,100,0
F 80,80,80

1111111111111111111111111
1000110000100000000000001
1000110000000000111111001
100011000000N000110001001
1000000000100000000001001
1111111111111111111111111