NO textures/north.xpm42
SO textures/south.xpm42
WE textures/west.xpm42
EA textures/east.xpm42
F 220,100,0
C 225,30,0

1111111111111111111111111
10N0110000100000000000001
1000110000000000111111001
1000110000000000110001001
1000000000100000000001001
1111111111111111111111111