
NO textures/wood.png
SO textures/wood_horiz.png
WE textures/purplestone.png
EA textures/colorstone.png

F 220,100,0
C 225,30,0

        1 111111111111111111111111
        1 000000000110000000000001
        1 011000001110000000000001
        110010000000000000000000001
111111111011000001110000000000001
1000000000110000011101011101111111
11110111111111011100000010001    
11110111111111011101010010001    
11000000110101011100000010001    
10000000000000001100000010001   
10000000000000001101010010N01    
1100000111010101111101111000111  
11110111 1110101 101111010001    
11111111 1111111 111111111111     
